$0000000000$
$0000000000$
$0000000000$
$00000p0000$
$$$$$$$$$$$$