iiiiiiiiiiiiiiiiiiiiiiiiiiiiiiii
10000000000000000000000000000001
10000000000022222200000000000001
10000000000000000000000000000001
10000000000000000000000000000001
10000022222000000000000000000001
10000000000000000000000000000001
10000000000000000000000000000001
12222000000000000000000000000001
11110000000000000000000000000001
11100000000000000000000000000001
11000002222000022222000000000001
10000001111000000000000000000001
10000000000000000000000000000001
10000000000000000000222220000001
10000000000000000000000000000001
10000000000000000000000000000001
10000000000000000000000000222221
10000000000000000000000000011111
10000000000000000000000000000111
10000000000000000000000220000011
10000000000000000000000110000001
10000000000000000000000000000001
10000000000000002222220000000001
10000000000000000000000000000001
10000000000000000000000000000001
10000000022222200000000000000001
10000000000000000000000000000001
10000000000000000000000000000001
10000222200000000000000000000001
10000000000000000000000000000001
1f000000000000000000000000222221
12222000000000000000000000001111
11110002000000000000000000000011
11100000000000000000000000000001
11000000000000000000000000000001
10000000022220000000000000000001
10000000000000000000000000000001
10000000000000000000000000000001
10000000000000002222200000000001
10000000000000000000000000000001
10000000000000000000000000000001
10000000000022220000000000000001
10000000000000000000000002222221
10000002222000000000000000011111
10000000000000022222000000001111
1f000000000000000000000000000011
12222200000000000000000000000001
11110000222220000000000000000001
11000000000000000000000000000001
10000000000000000000000000000001
100000000000022222200000s0000001
10000000000000000000002222200001
10000000000000000000000000000001
10000000000000000000000000000001
10000000000000000000000000000001
10000000000000000000000000000001
10000000000000000000000000000001
11111111111111111111111111111111
