iiiiiiiiiiiiiiiiiiiiiiiiiiiiiiii
10000000000000000000000000000001
10000000000000000000000000000001
10000000000002222220000000000001
10000000000000000000000000000001
10000000000000000000000000000001
10000000222220000000000000000001
10000000111110000000000000000001
10000000000000000000000000000001
10000000000000022222000000000001
10000000000000000000000000000001
10000000000000000000000000000001
10000000000000022222000000000001
10000000000000000000000000000001
10000000000000000000000000000001
10000000022220000000000000000001
100000000000000000000000f0000001
10000000000000000000000000000001
10022222222000000222222000000001
10000000000000000000000000000001
100000000000000000000000000000e1
10000000000000000000000000222221
10000000000000000000000000011111
10000000000000000000000000001111
10000000000022222000222200000011
10000000000000000000000000000001
10000000000000000000000000000001
iiiiiiiiiiiiiiiiiiiiiiiiiiiiiiii
10000000000000000000000000000001
10000000000000000000000000000001
10000000000000000062222300000001
10000000000000000000000000000001
10000000000000000000000000000001
10000000000622230000000000000001
10000000000000000000000000000001
100000000000000000000f0000000001
10000000000000000006223000000001
10000000000000000000000000000001
100000000000000000000000000000e1
10000000000000000000006222222221
10000000000000000000000000511111
10000000000000000000000000051111
10000000000000000623000000000511
10000000000000000000000000000051
10000000000000000000000000000001
10000000000622230000000000000001
10000000000000000000000000000001
10000000000000000000000000000001
10000006223000000000000000000001
10000000000000000000000000000001
10f00000000000000000000000000001
12222300000000000000000000000001
11114000000000000000000000000001
11140000000000000000000000000001
11400000622300000000000000000001
14000000000000000000000000000001
10000000000000000e00000000000001
10000000000000622300000000000001
10000000000000000000000000000001
10000062230000000000000000000001
10000000000000000000000000000001
10000000000000000000000000000001
10000000622230000000000000000001
10000000000000000000000000000001
10000000000000000000000000000001
10000000000000000000000000000001
12222222300000000000000000000001
11111140000000000000000000000001
11111400000006222230000000000001
11114000000000000000000000000001
11400000000000000000000000000001
14000000006223000000000000000001
10000000000000000000000000000001
10000000000000000000000000000001
10000000000000062222230000000001
10000000000000000000000000000001
10000000000000000000000000000001
10000000000000f00000000000000001
10000000000062300000000000000001
10000000000000000000000000000001
10000000000000000000000000000001
10000000000000000000000000000001
10000006222300000000000000000001
10000000000000000000000000000001
10000000000000000000000000000001
12230000000000000000000000000001
11400000000000000000000000000001
14000000000000000000000000000001
10006222300006222300000000000001
10000000000000000000000000000001
10000000000000000000006300000001
10000000000000000000000000000001
100000000000000000000000000000e1
10000000000000000000000006222221
10000000000000000000000000051111
10000000000000000000000000000511
10000000000000000000622300000051
10000000000000000000000000000001
10000000000000000000000000000001
10000622230000006223000000000001
10000000000000000000000000000001
10000000000000000000000000000001
10000000006222300000000000000001
10000000000000000000000000000001
10000000000000000000000000000001
10000822270000000000000000000001
10000511140000000000000000000001
10000000000000000000000000000001
1##############################1
10000000000000000000000000000001
11111111111111111111111111111111