iiiiiiiiiiiiiiiiiiiiiiiiiiiiiiii
10000000000000000000000000000001
10000006230000000000000000000001
10000000000000000000000000000001
10000000000062223000006300000001
10000000000000000000000000000001
10000000000000000000000000000001
10000000000000000000000000622221
10000000000000000000000000051111
10000000000000000000000000000511
10000000622223000622222300000051
10000000000000000000000000000001
10000000000000000000000000000001
12223000000000000000000000000001
11140000000000000000000000000001
11400000000000000000000000000001
14000062223000000000000000000001
10000000000000000000000000000001
10000000000000000000000000000001
10000000000000622300000000000001
10000000000000000000000000000001
10000000000000000000000000000001
10000000000000000000622300000001
10000000000000000000000000000001
10000000000000000000000000000001
10000000000000622230000000000001
10000000000000000000000000000001
10000000000000000000000000000001
10000000000000000000622223000001
10000000000000000000000000000001
10000000000000000000000000000001
10000000000006222230000000000001
10000000000000000000000000000001
10000000000000000000000000000001
10000082227000000000000000000001
10000051114000000000000000000001
10000000000000000000000000000001
10000000000062223000000000000001
10000000000000000000000000000001
10000000000000000000000000000001
10000000000000000006222300000001
10000000000000000000000000000001
10000000000000000000000000000001
10000000000622223000000000000001
10000000000000000000000000000001
10000000000000000000000000000001
10000062223000000000000000000001
10000000000000000000000000000001
10000000000000000000000000000001
10000000000062223000000000000001
10000000000000000000000000000001
10000000000000000000000000000001
10000062223000000000000000000001
10000000000000000000000000000001
10000000000000000000000000000001
10822700000082227000000000000001
10511400000051114000000000000001
10000000000000000000000000000001
10000000000000000006222300000001
10000000000000000000000000000001
10000000000000000000000000000001
10000000000000000000000006222301
10000000000000000000000000000001
10000000000000000000000000000001
10000000000000000006222300000001
10000000000000000000000000000001
10000000000000000000000000000001
10000000000000000000000006222301
10000000000000000000000000000001
10000000000000000000000000000001
10000000000000000006222300000001
10000000000000000000000000000001
10000000000000000000000000000001
10000000000000000000000062222221
10000000000000000000000000511111
10000000000000000000000000005111
10000000622223006222223000000511
10000000000000000000000000000051
10000000000000000000000000000001
10622300000000000000000000000001
10000000000000000000000000000001
10000000000000000000000000000001
100000000g00000g0000000000000001
100000000d00000d0000000000000001
10000000000000000000000000000001
10000000000000000062223000000001
10000000000000000000000000000001
10000000000000000000000000000001
10000000000000000062223000000001
10000000000000000000000000000001
10000000000000000000000000000001
10000000008222270000000000000001
10000000005111140000000000000001
10000000000000000000000000000001
10000000000000006222230000000001
10000000000000000000000000000001
10000000000000000000000000000001
10000000006222300000000000000001
10000000000000000000000000000001
10000000000000000000000000000001
10008222700000000000000000000001
100051114000g00g0082227000000001
100000000000d00d0051114000000001
10000000000000000000000000000001
10000000000000000000000822270001
10000000000000000000000511140001
10000000000000000000000000000001
10000000000000000062223000000001
10000000000000000000000000000001
10000000000000000000000000000001
10000000000000000062223000000001
10000000000000000000000000000001
10000000000000000000000000000001
10000000000062230000000000000001
10000000000000000000000000000001
10000000000000000000000000000001
10000008222700000000000000000001
10000005111400000000000000000001
10000000000000000000000000000001
10622230000000000000000000000001
10000000000000000000000000000001
10000000000000000000000000000001
10622230000000000000000000000001
10000000000000000000000000000001
10000000000000000000000000000001
10000006223000000000000000000001
10000000000000000000000000000001
10000000000000000000000000000001
12222230000000000000000000000001
11111400000000000000000000000001
11114000000000000000000000000001
11400000822700000000000000000001
14000000511400000000000000000001
10000000000000000000000000000001
10000000000006222300000000000001
10000000000000000000000000000001
10000000000000000000000000000001
1##############################1
10000000000000000000000000000001
10000000000000000000000000000001
11111111111111111111111111111111