iiiiiiiiiiiiiiiiiiiiiiiiiiiiiiii
$000000000000000000000000000000$
$000000000000000000000000000000$
$000000000lmmmmr000000000000000$
$000000000000000000000000000000$
$00000000000000e000000000000000$
$000000000lmmmmr000000000000000$
$000000000000000000000000000000$
$000000000000000000000000000000$
$000lmmmr0000000000000000000000$
$000000000000000000000000000000$
$0000F0000000000000000000000000$
$000lmmmr0000000000000000000000$
$000000000000000000000000000000$
$000000000000000000j00000000000$
$000000000t0000t000lmr000lmr000$
$000000000b0000b000000000000000$
$0000000000000000000000000000e0$
$000000000000000004500045000450$
$000000000000000009800098000980$
$000000000000000000000000000000$
$0000lr0000lmmmmr00000000000000$
$000000000000000000000000000000$
$000000000000000000000000000000$
$0lr000000000000000000000000000$
$000000000000000000000000000000$
$000000000000000000000000000000$
$0000t0000t0000lr00000000000000$
$0000b0000b00000000000000000000$
$0000000000000000000000e0000000$
$00000000000000000lmmmmr0000000$
$000000000000000000000000000000$
$000000000000000000000000000000$
$0lmmr0000422222500000000000000$
$000000000611111700000000000000$
$0j0000000933333800000000000000$
$0lmmr0000000000000000000000000$
$000000000000000000000000000000$
$000000000000000000000000000000$
$000000lmmmmr000lr0000000000000$
$00000000000000000000f000000000$
$000000000000000000000000000000$
$000000000000000000000042225000$
$000000000000000000000093338000$
$000000000000000000000000000000$
$000000000000000lmmmr0000000000$
$000000000000000000000000000000$
$000000000000000000000000000000$
$000000000000000000000lmmmr0000$
$000000000000000000000000000000$
$000000000000000000000000000000$
$000000000000000000000lmmmr0000$
$000000000000000000000000000000$
$000000000000000000000000000000$
$000000000000000000000lmmmr0000$
$000000000000000000000000000000$
$000000000000000000000000000000$
$000000000000000000000000000lr0$
$000000000000000000000000000000$
$000000000000000000000000000000$
$0000000000t0000t00004222500000$
$0000000000b0000b00006111700000$
$000000000000000000009333800000$
$00lmmmmr0000000000000000000000$
$000000000000000000000000000000$
$000000000000000000000000000000$
$0000000004222250000lmmmmr00000$
$000000000933338000000000000000$
$000000000000000000000000000000$
$000000000000000000000000000f00$
$000000000000000000000000000000$
$000000000000000000000000000000$
$000000000000000lr000lmmmr00000$
$000042222250000000000000000000$
$000061111170000000000000000000$
$000093333380000000000000000000$
$0f0000000000000000000000000000$
$000000000000000000000000000000$
$000000000000000000000000000000$
$0t0000t00000000000000000000000$
$0b0000b00000000000000000000000$
$000000000000000000000000000000$
$00000000lmmmmr0000lmmmmr000000$
$000000000000000000000000000000$
$000000000000000000000000000000$
$00000000000000000000000000lr00$
$000000000000000000000000000000$
$000000000000000000000000000000$
$000000000422250000422225000000$
$000000000611170000611117000000$
$000000000933380000933338000000$
$00lmmmr00000000000000000000000$
$000000000000000000000000000000$
$000000000000000000000000000000$
$000000000lmmmr0000000000000000$
$000000000000000000lmmmmr000000$
$000000000000000000000000000000$
$000000000000000000000000000000$
$00000000000000000000000000lmmr$
$000000000000000000000000000000$
$000000000000000000000000000000$
$0000000000000000000t000t000000$
$0000000000000000000b000b000000$
$000000000042222500000000000000$
$000000000061111700000000000000$
$000000000093333800000000000000$
$##############################$
$000000000000000000000000000000$
$$$$$$$$$$$$$$$$$$$$$$$$$$$$$$$$