iiiiiiiiiiiiiiiiiiiiiiiiiiiiiiii
$000000000000000000000000000000$
$000000000000000000000000000000$
$000000000000000000000000000000$
$000000000000000000000000000000$
$000000000000000000000000000000$
$000000000000000000000000000000$
$000000000000000000000000000000$
$000000000000000000000000000000$
$000000000000000000000000000000$
$000000000000000000000000000000$
$000000000000000000000000000000$
$000000000000000000000000000000$
$000000000000000000000000000000$
$000000000000000000000000000000$
$000000000000000000000000000000$
$000000000000000000000000000000$
$000000000000000000000000000000$
$000000000000000000000000000000$
$000000000000000000000000000000$
$000000000000000000000000000000$
$000000000000000000000000000000$
$000000000000000000000000000000$
$000000000000000000000000000000$
$000000000000000000000000000000$
$000000000000000000000000000000$
$000000000000000000000000000000$
$000000000000000000000000000000$
$000000000000000000000000000000$
$000000000000000000000000000000$
$000000000000000000000000000000$
$000000000000000000000000000000$
$000000000000000000000000000000$
$000000000000000000000000000000$
$000000000000000000000000000000$
$000000000000000000000000000000$
$000000000000000000000000000000$
$000000000000000000000000000000$
$000000000000000000000000000000$
$000000000000000000000000000000$
$000000000000000000000000000000$
$000000000000000000000000000000$
$000000000000000000000000000000$
$000000000000000000000000000000$
$000000000000000000000000000000$
$000000000000000000000000000000$
$000000000000000000000000000000$
$000000000000000000000000000000$
$000000000000000000000000000000$
$000000000000000000000000000000$
$000000000000000000000000000000$
$000000000000000000000000000000$
$000000000000000000000000000000$
$000000000000000000000000000000$
$000000000000000000000000000000$
$000000000000000000000000000000$
$000000000000000000000000000000$
$000000000000000000000000000000$
$000000000000000000000000000000$
$000000000000000000000000000000$
$000000000000000000000000000000$
$000000000000000000000000000000$
$000000000000000000000000000000$
$000000000000000000000000000000$
$000000000000000000000000000000$
$000000000000000000000000000000$
$000000000000000000000000000000$
$000000000000000000000000000000$
$000000000000000000000000000000$
$000000000000000000000000000000$
$000000000000000000000000000000$
$000000000000000000000000000000$
$000000000000000000000000000000$
$000000000000000000000000000000$
$000000000000000000000000000000$
$000000000000000000000000000000$
$000000000000000000000000000000$
$000000000000000000000000000000$
$000000000000000000000000000000$
$000000000000000000000000000000$
$000000000000000000000000000000$
$000000000000000000000000000000$
$000000000000000000000000000000$
$000000000000000000000000000000$
$000000000000000000000000000000$
$000000000000000000000000000000$
$000000000000000000000000000000$
$000000000000000000000000000000$
$000000000000000000000000000000$
$000000000000000000000000000000$
$00000000000P000000000000000000$
$000000000004222250000000000000$
$000000000009333380000000000000$
$000000000000000000000000000000$
$00000000000000000lmmmmr0000000$
$000000000000000000000000000000$
$000000000000000000000000000000$
$00000000000000000lmmmmr0000000$
$000000000000000000000000000000$
$000000000000000000000000000000$
$0000000000lmmmmr00000000000000$
$000000000000000000000000000000$
$000000000000000000000000000000$
$000000000042222500000000000000$
$000000000061111700000000000000$
$000000000093333800000000000000$
$##############################$
$000000000000000000000000000000$
$$$$$$$$$$$$$$$$$$$$$$$$$$$$$$$$